
NO images/wall/wall.xpm
SO images/wall/wall.xpm
WE images/wall/wall.xpm
EA images/wall/wall.xpm

F 27,79,55
C 33,47,61

                         111111111
                        10000000001
                        10000000001
                         100000001
11111    111111111111111111000001
100011111100000000000000000000001
10000000000000111111111100000001
100011111100000000000000001111111
11011    11111111111110001                 1111111
10001111111000000000000001                10000001
10001000011011111111111111111111111      1000000001
1000000001101            1000000001     100000000001
1000100001101            1000000001111110000000000001
100011111110111111       10000000000000000000E0000001
100011000000000001       1000000001111110000000000001
100011000000000001       1000000001     100000000001
10001100000000000111111111000000001      1000000001
10001100000000000000000000000010001       100000011111111
1000110000000000011111111111110001        111111111111101
100001000000000001           100011111111111111111111111
100011000000000001          10001
100011000000000001         10001
100011000000000001        1110001
100011111111111111       1000111
10001            11111  10001
1001          111000001100011
101         11000000000000001
101        100000000000000011
101       1000000000000000011
101111111100000000100000000001
100000000000000001 10000000001
111111111100000000100000000001
          1000000000000000001
           10000000000000001
            110000000000011
              11100000111
                 111010001
                    11111            1