NO ./assets/BRICK_1A.xpm
SO ./assets/BRICK_2A.xpm
WE ./assets/TILE_3C.xpm
EA ./assets/TILE_1A.xpm

F 209,208,215
C 113,167,194


11111111111111111111
10000000000010000001
10000100000010111111
111111111010101
10001   1010101
10001   1111101
100011111000001
100000000000001
111111000111101
100000000000001
101111110000001
1000E0001001001
100000000001001
100000010001001
111111111111111
