NO ./assets/BRICK_1A.xpm
SO ./assets/BRICK_2A.xpm
WE ./assets/BRICK_1A.xpm
EA ./assets/BRICK_2A.xpm

F 27,79,55
C 33,47,61


111111111111111
100000000000101
100001000000101
111100000010101
100010000010101
100010001111101
100010000000001
100000000000001
111111000111101
100000000000001
100000010000001
100000001001001
10N000000001001
100000010001001
111111111111111
