NO images/wall/wall.xpm
SO images/wall/wall.xpm
WE images/wall/wall.xpm
EA images/wall/wall.xpm

F 27,79,55
C 33,47,61




111111 11
11   1101
101111111
110N1101
1111101
1111111   1
1    111111