NO ./assets/BRICK_1A.xpm
SO ./assets/BRICK_2A.xpm
WE ./assets/TILE_3C.xpm
EA ./assets/TILE_1A.xpm

F 209,208,215
C 113,167,194


11111111111111111111
10000000000010000001
10000100000010111111
1111111110101N1
100011111010101
100011111111101
100011111000001
100000000000001
111111011111101
100000000000001
111111110111111
100000001001001
100000000001001
100000100010011
111111111111111
